####################################
#S#  ##  ######## #        #     # #
# #   #             # #        #   #
#   # ##### ## ###### # #######  # #
### # ##                      #### #
#   #    #  #######   #   ###     E#
####################################
